30 30
192 192
5 5 5 5 5 5 5 5 5 5 5 5 5 5 5 5 5 5 5 5 5 5 5 5 5 5 5 5 5 5
5 0 0 0 0 0 0 0 0 0 0 0 0 0 0 0 0 0 0 0 0 0 0 0 0 0 0 0 0 5
5 0 5 5 5 5 5 5 5 5 5 5 5 5 0 0 0 0 0 0 0 0 5 0 5 0 0 0 0 5
5 0 0 0 0 0 0 0 0 0 0 0 0 5 0 0 0 0 0 0 0 0 5 0 5 0 0 0 0 5
5 0 5 5 5 5 5 5 5 5 5 5 0 5 0 0 0 0 0 0 0 0 5 0 5 0 0 0 0 5
5 0 0 0 0 0 0 0 0 0 0 5 0 5 0 0 0 0 0 0 0 0 5 0 5 0 0 0 0 5
5 0 0 0 0 0 0 0 0 0 0 5 0 5 0 0 0 0 0 0 0 0 5 0 5 0 0 0 0 5
5 0 0 0 0 0 0 0 0 0 0 5 0 5 0 0 0 0 0 0 0 0 5 0 5 0 0 0 0 5
5 0 0 0 0 0 0 0 0 0 0 5 0 5 0 0 0 0 0 0 0 0 5 0 5 0 0 0 0 5
5 0 0 0 0 0 0 0 0 0 0 5 0 5 0 0 0 0 0 0 0 0 5 0 5 0 0 0 0 5
5 0 0 0 0 0 0 0 0 0 0 5 0 5 0 0 0 0 0 0 0 0 5 0 5 0 0 0 0 5
5 0 5 5 5 5 5 5 5 5 5 5 0 5 5 5 5 5 5 5 5 5 5 0 5 0 0 0 0 5
5 0 5 0 0 0 0 0 0 0 0 0 0 0 0 0 0 0 0 0 0 0 0 0 5 0 0 0 0 5
5 0 5 0 5 5 5 5 5 5 5 5 0 5 5 5 5 5 5 5 5 5 5 5 5 0 0 0 0 5
5 0 5 0 5 0 0 0 0 0 0 5 0 5 0 0 0 0 0 0 0 0 0 0 0 0 0 0 0 5
5 0 5 0 5 0 0 0 0 0 0 5 0 5 0 0 0 0 0 0 0 0 0 0 0 0 0 0 0 5
5 0 5 0 5 0 0 0 0 0 0 5 0 5 0 0 0 0 0 0 0 0 0 0 0 0 0 0 0 5
5 0 5 0 5 0 0 0 0 0 0 5 0 5 0 0 0 0 0 0 0 0 0 0 0 0 0 0 0 5
5 0 5 0 5 0 0 0 0 0 0 5 0 5 5 5 5 5 5 5 5 5 5 5 5 0 0 0 0 5
5 0 5 0 5 0 0 0 0 0 0 5 0 0 0 0 0 0 0 0 0 0 0 0 0 0 0 0 0 5
5 0 5 0 5 0 0 0 0 0 0 5 5 5 5 5 5 5 5 5 5 5 5 5 5 0 0 0 0 5
5 0 0 0 0 0 0 0 0 0 0 0 0 0 0 0 0 0 0 0 0 0 0 0 0 0 0 0 0 5
5 0 0 0 0 0 0 0 0 0 0 0 0 0 0 0 0 0 0 0 0 0 0 0 0 0 0 0 0 5
5 0 0 0 0 0 0 5 0 0 0 0 0 0 0 0 0 0 0 0 0 0 0 0 0 0 0 0 0 5
5 0 0 0 0 0 0 0 5 5 5 5 5 5 5 5 5 5 0 0 0 0 0 0 0 0 0 0 0 5
5 0 0 0 0 0 0 0 0 0 0 0 0 0 0 0 0 5 5 0 0 0 0 0 0 0 0 0 0 5
5 0 0 0 0 0 0 0 5 5 5 5 5 5 5 5 5 5 0 0 0 0 0 0 0 0 0 0 0 5
5 0 0 0 0 0 0 5 0 0 0 0 0 0 0 0 0 0 0 0 0 0 0 0 0 0 0 0 0 5
5 0 0 0 0 0 0 0 0 0 0 0 0 0 0 0 0 0 0 0 0 0 0 0 0 0 0 0 0 5
5 5 5 5 5 5 5 5 5 5 5 5 5 5 5 5 5 5 5 5 5 5 5 5 5 5 5 5 5 5